18 18 18 18 18 18 18 18 18 18 18 18 18 18 18 18 18 18 18 18 18 18 18 18 18 18 18 18 18 18 18 18 18 18 18 18 18 18 18 18 18 18 18 18 18 18 18 18 18 18 
18 18 18 18 18 18 18 18 18 18 18 18 18 18 18 18 18 18 18 18 18 18 18 18 18 18 18 18 18 18 18 18 18 18 18 18 18 18 18 18 18 18 18 18 18 18 18 18 18 18 
18 18 18 18 18 18 18 18 18 18 18 18 18 18 18 18 18 18 18 18 18 18 18 18 18 18 18 18 18 18 18 18 18 18 18 18 18 18 18 18 18 18 18 18 18 18 18 18 18 18 
18 18 18 18 18 18 18 18 18 18 18 18 18 18 18 18 18 18 18 18 18 18 18 18 18 18 18 18 18 18 18 18 18 18 18 18 18 18 18 18 18 18 18 18 18 18 18 18 18 18 
18 18 18 18 18 18 18 18 18 18 18 18 18 18 18 18 18 18 18 18 18 18 18 18 18 18 18 18 18 18 18 18 18 18 18 18 18 18 18 18 18 18 18 18 18 18 18 18 18 18 
18 18 18 18 18 18 18 22 23 23 23 23 23 23 23 23 23 23 23 23 23 23 23 23 23 23 23 20 18 18 18 18 18 18 18 18 18 18 18 18 18 18 18 18 18 18 18 18 18 18 
18 18 18 18 18 18 18 25 16 16 16 16 16 11 8 8 8 8 8 8 8 8 8 8 13 0 0 19 23 23 23 23 23 23 23 23 23 23 23 23 20 18 18 18 18 18 18 18 18 18 
18 18 18 18 18 18 18 25 16 1 1 1 16 10 2 2 2 2 2 2 2 2 2 2 9 0 15 15 15 15 15 15 15 0 0 0 0 0 0 0 24 18 18 18 18 18 18 18 18 18
18 18 18 18 18 18 18 25 16 1 1 1 0 10 2 2 2 2 2 2 2 2 2 2 9 0 15 15 15 15 15 15 15 0 0 0 0 0 0 0 24 18 18 18 18 18 18 18 18 18
18 18 18 18 18 18 18 25 16 1 1 1 16 10 2 2 2 2 2 2 2 2 2 2 9 15 15 15 15 15 15 15 15 0 0 0 0 0 0 0 24 18 18 18 18 18 18 18 18 18
18 18 18 18 18 18 18 25 16 1 1 1 16 4 7 7 7 7 7 7 7 7 12 2 9 15 15 15 15 15 15 15 15 0 0 0 0 0 0 0 24 18 18 18 18 18 18 18 18 18 
18 18 18 18 18 18 18 25 16 16 16 16 16 15 15 15 15 15 15 15 15 15 10 2 9 15 15 15 15 15 15 15 15 0 0 0 0 0 0 0 24 18 18 18 18 18 18 18 18 18
18 18 18 18 18 18 18 25 15 15 15 15 15 15 15 15 15 15 15 15 15 15 10 2 9 15 15 15 15 15 15 15 15 15 15 0 0 0 27 26 28 18 18 18 18 18 18 18 18 18 
18 18 18 18 18 18 18 25 15 15 15 15 15 15 15 15 15 15 15 15 15 15 10 2 9 15 15 15 15 15 15 15 15 15 15 15 0 27 28 18 18 18 18 18 18 18 18 18 18 18 
18 18 18 18 18 18 18 25 15 15 15 15 15 15 15 15 15 15 15 15 15 15 10 2 9 15 15 15 15 15 15 15 15 15 15 15 0 24 18 18 18 18 18 18 18 18 18 18 18 18 
18 18 18 18 18 18 18 25 15 15 15 15 15 15 15 15 15 15 15 15 15 15 10 2 9 15 15 15 15 15 15 15 15 15 15 15 0 19 20 18 18 18 18 18 18 18 18 18 18 18 
18 18 18 18 18 18 18 25 15 15 15 15 15 15 15 15 15 15 15 15 15 15 4 7 6 15 15 15 15 15 15 15 15 15 15 11 8 13 24 18 18 18 18 18 18 18 18 18 18 18
18 18 18 18 18 18 18 25 15 15 15 15 15 15 15 15 15 15 15 15 15 15 15 0 15 15 15 15 15 15 15 15 15 15 15 10 2 9 24 18 18 18 18 18 18 18 18 18 18 18 
18 18 18 18 18 18 18 25 15 15 15 15 15 15 15 15 15 15 15 15 15 15 11 8 13 15 15 15 15 15 15 15 15 15 15 10 2 9 24 18 18 18 18 18 18 18 18 18 18 18 
18 18 18 18 18 18 18 25 15 15 15 15 15 15 15 15 15 15 15 15 15 15 10 2 9 15 15 15 15 15 15 15 15 15 15 10 2 9 24 18 18 18 18 18 18 18 18 18 18 18 
18 18 18 18 18 18 18 25 11 8 8 8 8 8 8 8 8 8 8 8 8 8 5 2 3 8 8 8 8 8 8 8 8 8 8 5 2 9 19 20 18 18 18 18 18 18 18 18 18 18
18 18 18 18 18 18 18 25 10 2 2 2 2 2 2 2 2 2 2 2 2 2 2 2 2 2 2 2 2 2 2 2 2 2 2 2 2 9 0 24 18 18 18 18 18 18 18 18 18 18
18 18 18 18 18 18 18 25 4 7 7 7 7 7 7 7 7 7 7 7 7 7 12 2 14 7 7 7 7 7 7 7 7 7 7 12 2 9 0 24 18 18 18 18 18 18 18 18 18 18
18 18 18 18 18 18 18 25 15 15 15 15 15 15 15 15 15 15 15 15 15 0 10 2 9 0 15 15 15 15 15 15 15 15 15 10 2 9 0 24 18 18 18 18 18 18 18 18 18 18
18 18 18 18 18 18 18 25 15 15 15 15 15 15 15 15 15 15 15 15 15 0 10 2 9 0 15 15 15 15 15 15 15 15 15 10 2 9 0 24 18 18 18 18 18 18 18 18 18 18 
18 18 18 18 18 18 18 25 15 15 15 15 15 15 15 15 15 15 15 15 15 15 10 2 9 15 15 15 15 15 15 15 15 15 15 10 2 9 0 24 18 18 18 18 18 18 18 18 18 18 
18 18 18 18 18 18 18 25 15 15 15 15 15 15 15 15 15 15 15 15 15 15 10 2 9 15 15 15 15 15 15 15 15 15 15 10 2 9 0 24 18 18 18 18 18 18 18 18 18 18 
18 18 18 18 18 18 18 25 15 15 15 15 15 15 15 15 15 15 15 15 15 15 10 2 9 15 15 0 15 15 15 15 15 15 15 4 7 6 0 24 18 18 18 18 18 18 18 18 18 18
18 18 18 18 18 18 18 25 15 15 15 15 15 15 15 15 15 15 15 15 15 15 10 2 9 15 15 15 15 15 0 15 15 15 15 15 0 15 27 28 18 18 18 18 18 18 18 18 18 18 
18 18 18 18 18 18 18 25 15 15 15 15 15 15 15 15 15 15 15 15 15 15 10 2 9 15 15 15 15 15 0 15 15 15 15 0 0 0 24 18 18 18 17 18 18 18 18 18 18 18  
18 18 18 18 18 18 18 25 15 15 15 15 15 15 15 15 15 15 15 15 15 15 10 2 9 15 15 15 15 15 15 15 15 15 15 0 0 0 24 18 17 18 18 18 18 18 18 18 18 18 
18 18 18 18 18 18 18 25 15 15 15 15 15 15 15 15 15 15 15 15 15 15 10 2 9 15 15 15 15 15 15 15 15 15 15 0 0 0 24 18 17 18 18 18 18 18 18 18 18 18  
18 18 18 18 18 18 18 25 15 15 15 15 15 15 15 15 15 15 15 15 15 15 10 2 9 15 15 15 15 15 15 15 15 15 15 0 0 0 24 18 18 18 17 18 18 18 18 18 18 18  
18 18 18 18 18 18 18 25 15 15 15 15 15 15 15 15 15 15 15 15 15 15 10 2 9 15 15 15 15 15 15 15 15 15 15 0 0 0 24 18 18 18 18 18 18 18 18 18 18 18  
18 18 18 18 18 18 18 25 15 15 15 15 15 15 15 15 15 15 15 15 15 15 10 2 9 15 15 15 15 15 15 15 15 15 15 0 0 0 19 20 17 17 18 18 18 18 18 18 18 18 
18 18 18 18 18 18 18 25 15 15 15 15 15 15 15 15 15 15 15 15 15 15 10 2 9 15 15 15 15 15 15 15 15 15 15 0 0 0 0 24 18 18 18 18 18 18 18 18 18 18 
18 18 18 18 18 18 18 25 15 15 15 15 15 15 15 15 15 15 15 0 0 0 4 7 6 0 0 15 15 15 15 15 15 15 0 0 0 0 0 24 18 18 18 17 18 18 18 18 18 18
18 18 18 18 18 18 18 25 15 15 15 15 15 15 15 15 15 15 0 0 0 0 0 0 0 0 0 0 15 15 0 15 15 0 0 0 0 0 0 24 18 18 18 18 18 18 18 18 18 18 
18 18 18 18 18 18 18 25 15 15 15 15 15 15 15 15 15 15 0 0 0 0 0 0 0 0 0 0 15 15 15 15 0 0 0 0 0 0 0 24 18 18 17 18 18 18 18 18 18 18
18 18 18 18 18 18 18 25 15 15 15 15 15 15 15 15 15 15 0 0 0 0 0 0 0 0 0 0 0 15 15 15 0 0 0 0 0 15 0 24 18 17 18 17 18 18 18 18 18 18 
18 18 18 18 18 18 18 25 15 15 15 15 15 15 15 15 15 15 0 0 0 0 0 0 0 0 0 0 0 0 0 0 0 0 15 0 0 0 0 24 18 18 18 18 18 17 18 18 18 18 
18 18 18 18 18 18 18 18 26 26 26 26 26 26 26 26 26 26 29 0 0 0 0 0 0 0 0 27 26 26 29 0 0 0 0 0 0 0 0 24 18 18 18 18 18 18 18 18 18 18 
18 18 18 18 18 18 18 18 18 18 18 18 18 18 18 18 18 18 30 29 0 0 0 0 0 0 27 28 18 18 25 0 0 15 0 0 15 0 0 24 18 18 18 18 18 18 18 18 18 18
18 18 18 18 18 18 18 18 18 18 18 18 18 17 18 18 18 18 18 30 26 26 26 26 26 26 28 18 18 18 30 26 26 26 26 26 26 26 26 28 17 18 18 18 18 18 18 18 18 18
18 18 18 18 18 18 18 18 18 18 18 18 18 18 18 18 18 18 18 18 18 18 18 18 18 18 18 18 18 18 18 18 18 18 18 17 18 18 18 18 18 18 17 18 18 18 18 18 18 18
18 18 18 18 18 18 18 18 17 18 18 18 18 18 18 18 17 18 18 17 18 18 18 18 18 18 18 17 18 18 17 18 18 18 18 18 18 18 18 18 17 18 18 17 18 18 18 18 18 18
18 18 18 18 18 18 18 18 18 18 18 18 18 18 18 18 18 18 18 18 18 18 17 18 18 17 18 18 18 18 18 17 18 18 17 18 18 18 17 18 18 18 18 18 18 18 18 18 18 18
18 18 18 18 18 18 17 18 18 18 18 17 18 18 18 18 18 18 18 18 18 18 18 18 18 18 18 18 17 18 18 18 18 18 18 18 18 18 17 18 18 18 18 18 18 18 18 18 18 18
18 18 18 18 18 18 18 18 18 18 18 18 18 18 18 18 18 18 18 18 18 18 18 18 18 18 18 18 18 18 18 18 17 18 18 18 18 18 18 18 18 18 18 18 18 18 18 18 18 18
18 18 18 18 18 18 18 18 18 18 18 18 18 18 18 18 18 18 17 18 18 18 18 18 18 18 18 18 18 18 18 18 18 18 18 18 18 18 18 18 18 18 18 18 18 18 18 18 18 18